extracted_triple	utterance-1	utterance	utterance+1
('Monica', 'has-brother', 'Rachel')	['Rachel', " Oh God Monica hi! I just went to your building and you weren't there and then this guy with a big hammer said you might be here and you are, you are!"]	['Monica', ' Okay, everybody, this is Rachel, another Lincoln High survivor. This is everybody, this is Chandler, and Phoebe, and Joey, and- you remember my brother Ross? ']	['Rachel', ' Hi, sure!']
('Monica', 'has-brother', 'Paul')	['Paul', " I know, I know, I'm such an idiot. I guess I should have caught on when she started going to the dentist four and five times a week. I mean, how clean can teeth get?"]	['Monica', " My brother's going through that right now, he's such a mess. How did you get through it?"]	['Paul', ' Well, you might try accidentally breaking something valuable of hers, say her-']
('Monica', 'has-brother', 'Angela')	['Angela', " You know what else? He's unbelievable in bed."]	['Monica', ' Wow. My brother never even told me when he lost his virginity.']	['Angela', " Huh. That's nice."]
('Monica', 'has-brother', 'Chandler')	['Chandler', ' Yes! Good thing we have that, ‘Not in New York’ rule.']	['Monica', ' Right. Umm, listen since we’re-we-re on that subject, umm, I just wanted to tell you that uh, well, I-I was going through a really hard time in London, what with my brother getting married and that guy thinking I was Ross’s mother…']	['Chandler', ' Right.']
('Monica', 'has-brother', 'Joey')	['Chandler', " Okay y'know what, because you said that, I'm not putting out tonight."]	['Monica', " I'm telling you, something's wrong! My brother does not stay out all night."]	['Joey', ' Maybe we should check the trash chute.']
('Monica', 'has-brother', 'Ross')	['Rachel', ' Wait a minute! You let Ross drive the Porsche and when I ask you, you say you’re the only one who’s allowed to drive it.']	['Monica', ' Yeah, well he’s my brother! And plus he drives so slow he could never hurt it.']	['Ross', ' It’s a car Monica! Not a rocket ship!']
('Phoebe', 'has-brother', 'Frank')	['Joey', ' Lean-lean-lean!']	['Phoebe', ' Oh my God! I can’t believe my little brother is married!']	['Frank', ' Oh I know!!']
('Phoebe', 'has-brother', 'Joey')	['Ross', ' Pheebs, what, is it the age thing?']	['Phoebe', " No-no, oh, I’m fine with the age thing y'know, until it starts sticking it’s tongue down my little brother’s throat! "]	['Joey', ' Pheebs, he seems to enjoy it.']
('Phoebe', 'has-brother', 'Pete')	['Alice', ' Oh no-no, never say that. If we can’t get it out then we can cut around the stain, add a little lace, you make a stylish throw.']	['Phoebe', ' Or instead, maybe you could just not marry my brother Frank.']	['Pete', ' Okay, that’s great, but can we make it smaller? Can we make it fit on the head of a pin? I love when we make things fit on the head of a pin.']
('Phoebe', 'has-brother', 'Nurse')	['Nurse', ' Now, which of you is the father?']	['Phoebe', ' Oh no, none of them are the father. The father is my brother.']	['Nurse', ' Okay…']
('Joey', 'has-brother', 'Chandler')	['Chandler', " So you didn't uh, choose Ross before me."]	['Joey', " No! I would never do that! You-you're like my brother!"]	['Chandler', ' Really?!']
('Phoebe', 'has-brother', 'Chandler')	['Joey', ' Hey! It’s Porsche!!']	['Phoebe', ' Me taking care of you is no problem, huh? You guys feel safe. Right? Okay, I’m gonna take that spit bubble as, "Yeah, I do!" Okay, after I get rid of this dirty diaper Leslie, I’ll set you up with a clean one. Okay, I’m sorry. I didn’t mean to scare you. I just have to clean that up. Okay? ‘Cause let’s face it, we’re at Monica’s. I broke it. All right. Well, that’s just the way that goes. Okay, good. Why are there only two of you? Where is Leslie? Well, you can’t answer. Leslie? Where are you Leslie? Leslie, now would be a good time for your first words! Well, look at you! Hey! You are a little bit mischievous! My gosh! Oh, you’re a lot mischievous! Well, it’ll dry. Okay, you sit with your brother and sister now—who aren’t there!']	['Chandler', ' Hey!']
('Ross', 'has-brother', 'Joey')	['Rachel', ' Oh so-so not really never.']	['Ross', ' I have to say you are a much bigger person than I am. I mean after all we’ve been through, I just—y’know I wish I had a brother to reciprocate. Hey, if you ever want to go out with Monica, you have my blessing.']	['Joey', ' Oh-ho, and mine!']
('Monica', 'has-brother', 'Frannie')	['Ross', ' Hi Frannie, congratulations.']	['Monica', ' You invite my brother, you invite my whole family, and not me?! Why?! What—Why wouldn’t you want me at your wedding? What could I have possibly done?! Stuart!']	['Frannie', ' I believe you know my husband.']
('Ross', 'has-brother', 'Chandler')	['Chandler', ' Do I still call you Ross?']	['Ross', ' Okay! You guys are getting married tomorrow and-and I couldn’t be more thrilled for both of you, but as Monica’s older brother I-I have to tell you this. If you ever hurt my little sister, if you ever cause her any unhappiness of any kind, I will hunt you down, and kick your ass! What? I’m-I’m-I’m serious! Come—Hey! Dude! Stop it! Okay? I’m-I’m not kidding here!']	['Chandler', ' Hey, I hear what your saying, okay? And, thanks for the warning.']
('Ross', 'has-brother', 'Monica')	['Chandler', ' Mr. and Mrs. Bing!']	['Ross', ' Wow Monica! Hey, just so you know I had my uh, older brother chat with Chandler.']	['Monica', ' What is that?']
('Dina', 'has-brother', 'Joey')	['Joey', ' Because! ‘Cause… ‘Cause you’re my baby sister!']	['Dina', ' And you’re my big brother! I mean, you’re my favorite guy in the whole world. I’m not even scared to tell mom and dad. I was scared of telling you.']	['Joey', ' Well I’d be scared of them, but all right.']
('Ross', 'has-sister', 'Joey')	['Monica', ' Oh no!']	['Ross', ' You slept with my sister?']	['Joey', ' Uh yes, but it was, we just did it once uh, in London.']
('Ross', 'has-sister', 'Phoebe')	['Monica', ' Well umm, Chandler and I are moving in together.']	['Ross', ' Oh my God. Ohh, my little sister and my best friend…shaking up. Oh, that’s great. That’s great.']	['Phoebe', ' Guys, I’m happy too.']
('Rachel', 'has-sister', 'Phoebe')	['Phoebe', ' Okay then.']	['Rachel', ' Oh my God! I can not believe that! I mean I don’t really like it when Ross goes out with anyone, but my sister isn’t that like incest or something?! Oh my God, and they’re gonna have sex! Oh! Oh no what if he marries her too?! Oh this is just terrible, this is just terrible. And I can’t stop it! I can’t—I don’t own Ross! Y’know? And Jill, she should be able to do whatever it is that she wants to do! And oh my God, I can’t believe Ross is marrying my little sister, this terrible. Oh my God, this is just the worst thing that could have ever happened to me.']	['Phoebe', ' But great news about the apartment pants, huh?']
('Joey', 'has-sister', 'Rachel')	['Rachel', ' Oh Joey, I’m hardly a…']	['Joey', ' My little sister Dina!']	['Rachel', ' Right! Hi Dina! ']
('ROSS', 'has-sister', 'MNCA')	['FBOB', " Hey. Whoa, hey, you've been working out, huh?"]	['ROSS', " Not at all! I love this guy. Hey, I was so psyched to hear you're back with my sister!"]	['MNCA', ' You and me both.']
('Phoebe', 'has-sister', 'Malcom')	['Malcom', " I'm sorry. I'm sorry. I tried to stop, but I couldn't. I'm so pathetic."]	['Phoebe', " No, no, it's not your fault. You know it's partly my fault, 'cause I made you quit cold turkey. Sorry, no. Okay, well, I mean, I can't date you anymore, 'cause your, you know Wow! But um, but I will definitely, definitely help you get over my sister. Okay, stalk me for a while. Huh? Yeah, and, and, and, I'll be like an Ursula patch."]	['Malcom', " Uh-huh, I don't know."]
('Phoebe', 'has-sister', 'Rachel')	['Rachel', ' There you go!']	['Phoebe', ' I did it! One mile on a hippity-hop! That’s it!! That’s everything I wanted to do before I was thirty. Oh, except I wanted to patch things up with my sister. But oh well. Yay!! And-and girls this thing is a Godsend if you know what I mean.']	['Rachel', ' Thirty. Ugh, I mean thirty! Monica, do you remember mean, old Mrs. Kreeger in the fifth grade? She was thirty!']
('Frank', 'has-sister', 'Phoebe')	['Phoebe', ' Right, okay, um-mm.']	['Frank', " Yeah, y'know I feel like I can really talk to you ‘cause y'know you’re my sister, y'know."]	['Phoebe', ' Yeah, I guess I do, yeah.']
('Eric', 'has-sister', 'Chandler')	['Eric', ' Oh, yeah, during the summer, I spend most weekends at my sister’s beach house, which you are welcome to use by the way. Although, I should probably tell you, she’s a porn star.']	['Chandler', ' Well, listen I ah, still have one more person to ah meet, but unless it turns out to be your sister, I think you’re chances are pretty good. All right.']	['Chandler', ' Bedroom. Bathroom. Living room. This right here is the kitchen, and thanks for coming by, Bye-bye.']
('Joey', 'has-sister', 'Ross')	['Chandler', ' Why can’t we talk in here? With, with, witnesses.']	['Joey', ' I just got off the phone with my sister.']	['Ross', ' Ah, which, which one?']
('Joey', 'has-sister', 'Chandler')	['Chandler', ' Yuck!']	['Joey', ' I can’t believe Ross went out with Rachel’s sister! When Chandler made out with my sister I was mad at him for 10 years.']	['Chandler', ' That was like 5 years ago.']
('Richard', 'has-sister', 'Monica')	['Monica', ' Sounds smart and healthy to me. So um, just out of curiosity, um, do you currently have any other racquetball buddies?']	['Richard', ' Just your dad. Although that’s actually racquetball. You know I-I do have a blind date with my sister’s neighbour next Tuesday.']	['Monica', ' Oh.']
('Rachel', 'has-sister', 'All')	['Chandler', ' Nope, hymn 253, His Eyes Are On The Sparrow! When my parents got divorced is when I started using humour as a defence mechanism.']	['Rachel', ' Hi! Uhh, do you guys have plans for the weekend? Because I have my sister on hold, and she said that we could use her cabin for the weekend and go skiing. Huh? I’m asking you first, right?!. I mean I’m playing by the rules.']	['All', ' Absolutely, yeah!']
('Ross', 'has-sister', 'Emily')	['Emily', ' She said, "If I’m not gonna be happy getting married somewhere that we find in a day, well then we should just postpone it."']	['Ross', ' Postpone it? Emily, do you think Monica realises how much our parents spent on this wedding? Do you my sister’s teeny-tiny little brain comprehends that people took time out of their lives to fly thousands of miles to be here, huh? This isn’t right.']	['Emily', ' I realize that people are going to be disappointed. But, I’m sure they’ll come back when we can do it right.']
('Ross', 'has-sister', 'Dr. Leedbetter')	['Dr. Leedbetter', ' A sandwich?']	['Ross', ' Yeah. You see my-my sister makes these amazing turkey sandwiches. Her secret is, she puts a, an extra slice of gravy soaked bread in the middle; I call it the Moist Maker. Anyway, I-I put my sandwich in the fridge over here… ']	['Dr. Leedbetter', ' Oh, you know what?']
('Ross', 'has-sister', 'Monica')	['The Professor', ' Do you have a moment to talk about your lecture?']	['Ross', ' I’m sorry, I’ve got plans with my sister.']	['Monica', ' Monica Gellerrr.']
('Danny', 'has-sister', 'Rachel')	['Danny', " I'd love to ask you in, but uh, my sister's visiting and I think she's asleep on the couch."]	['Rachel', " You're sister? You're sister's asleep on the couch? Ohhh! I saw her with you on the subway and now she's asleep on the couch!"]	['Danny', " Oh hey, great, you're up. Rachel, this is my sister Krista. Krista, this is Rachel."]
('Ross', 'has-sister', 'Chandler')	['Chandler', ' Ross!']	['Ross', ' Hiiii-Ya!! I’m serious! You’re not walking out on my sister!']	['Chandler', ' That’s right! I’m not!']
('Ross', 'has-sister', 'Rachel')	['Monica', " I'm so sorry that you had to find out this way. I'm sorry, but it's true, I love him too."]	['Ross', ' My best friend and my sister! I cannot believe this. You guys probably wanna get some hugs in too, huh? Big news!']	['Rachel', " Awww, no, it's okay, we've actually known for a while."]
('Phoebe', 'has-sister', 'Chandler')	['Joey', ' Hey! It’s Porsche!!']	['Phoebe', ' Me taking care of you is no problem, huh? You guys feel safe. Right? Okay, I’m gonna take that spit bubble as, "Yeah, I do!" Okay, after I get rid of this dirty diaper Leslie, I’ll set you up with a clean one. Okay, I’m sorry. I didn’t mean to scare you. I just have to clean that up. Okay? ‘Cause let’s face it, we’re at Monica’s. I broke it. All right. Well, that’s just the way that goes. Okay, good. Why are there only two of you? Where is Leslie? Well, you can’t answer. Leslie? Where are you Leslie? Leslie, now would be a good time for your first words! Well, look at you! Hey! You are a little bit mischievous! My gosh! Oh, you’re a lot mischievous! Well, it’ll dry. Okay, you sit with your brother and sister now—who aren’t there!']	['Chandler', ' Hey!']
('Ross', 'has-sister', 'Janine')	['Joey', ' Ye-ye, we go to yours!']	['Ross', ' Yeah, see, we-we-we have to stop across the hall, because it’s my sister. But, uh, uh y’know actually, growing up with a sister was nice because it really helped me understand women. Yeah, you-you should tell your friends that.']	['Janine', ' Okay.']
('Rachel', 'has-sister', 'Joey')	['Rachel', ' Ross is on a date with my sister and they shut the drapes two and a-half-hours ago.']	['Joey', ' Whoa, I didn’t know we could date your sister!']	['Monica', ' Joey we know you steal our food.']
('Rachel', 'has-sister', 'Ross')	['Ross', ' He is my girlfriend’s father, okay? It’s-it’s, it’s weird!']	['Rachel', ' Wh—You dated my sister!']	['Ross', ' That was different!']
('Rachel', 'has-sister', 'Jill')	['Jill', ' Why?!']	['Rachel', ' Because you are my sister and Ross and I have this huge history…']	['Jill', ' I don’t understand, do you want to go out with Ross?']
('Joey', 'has-sister', 'Joey')	['Chandler', '  Oh, ok.']	['Joey', ' There\'s my scene, there\'s my scene. [Joey on tv] "Mrs. Wallace, I\'m Dr. Drake Ramoray, your sister\'s neurosurgeon.  I\'m afraid the situation is much worse than we expected. Your sister is suffering from a..."']	['Joey', " Vell, Eva, ve've done some excellent vork here, and I vould have to say, your pwoblem is qviiite clear. "]
('Tag', 'has-sister', 'Rachel')	['Rachel', ' Oh how can you possibly know? Look at this mess, Tag! I mean, this is what I’m talking about! You have to be organized! You’ve got newspapers! You’ve got magazines! You got—Ohh! And who is this chippy? A little young for you Tag, but whatever.']	['Tag', ' It’s my sister.']	['Rachel', ' Okay, very cute braces. Anyway y’know what, the point is Tag, start looking because you are going to find those contracts on your desk.']
('Ross', 'has-sister', 'All')	['Mr. Geller', ' Doctor Ross Geller.']	['Ross', ' Dad…dad, please! As I was saying umm, I’m Dr. Ross Geller. Uhh, and I’m the best man. And uh, this marriage is doubly special for me umm, because not only is the groom my best friend but uh, the bride is my little sister. And, she’s the greatest sister a guy could ask for. So if you’d all please join me in raising a glass to the, the couple we’re here to celebrate. To the Bings.']	['All', ' To the Bings!']
('Ursula', 'has-sister', 'Phoebe')	['Phoebe', ' Really?']	['Ursula', ' Sure! Why not? You could be my sister for the day.']	['Phoebe', ' Yeah. Okay. Umm, y’know, my friends are having a Halloween party tonight at my old apartment so, you could come. Maybe I could meet the guy you’re marrying.']
('Eric', 'has-sister', 'Phoebe')	['Phoebe', ' Ursula’s fianc�e?']	['Eric', ' Oh my God, you’re the sister!']	['Phoebe', ' Yeah.']
('Phoebe', 'has-sister', 'Eric')	['Eric', ' Anyway, I was wondering if, you were the sort of person who…eats lunch.']	['Phoebe', ' Are you asking me out? ‘Cause it would be kinda weird since you just broke up with my sister.']	['Eric', ' Yeah uh…okay. I’m-I’m sorry. Bye.']
('Joey', 'has-sister', 'Dina')	['Dina', ' Look, Rachel’s told me how much easier you’ve made all this on her. Why can’t you do that for me?']	['Joey', ' Because! ‘Cause… ‘Cause you’re my baby sister!']	['Dina', ' And you’re my big brother! I mean, you’re my favorite guy in the whole world. I’m not even scared to tell mom and dad. I was scared of telling you.']
('Rachel', 'has-sisters', 'Ben')	['Ben', ' Sharing is good.']	['Rachel', ' Oh, you’re one of those. But y’know what? I have two sisters of my own and we just-just tortured each other.']	['Ben', ' Really? Like how?']
('Joey', 'has-sisters', 'Rachel')	['Rachel', ' Joey. Joey, something feels weird and not good weird. I don’t—Whoa!!']	['Joey', ' Oh hey whoa-whoa, don’t worry. Okay. When my sisters were pregnant they got every weird feeling in the book, it was always nothing.']	['Rachel', ' Really?']
('Chandler', 'has-cousin', 'Ross')	['Ross', ' Why? ']	['Chandler', " I need you to come to this bachelor party for my weird cousin Albert, y'know he's the botanist. "]	['Ross', " Oh God. Y'know, botanists are such geeks. "]
('Monica', 'has-cousin', 'Chandler')	['Monica', ' Hi! If you’re calling before Saturday, you’ve reached Monica and Chandler. But if you’re calling after Saturday, you’ve reached Mr. and Mrs. Bing! Please leave a message for the Bings!']	['Monica', ' Hey Maureen! Gosh! Hey uh, Chandler? This is my cousin Maureen.']	['Chandler', ' We’re the Bings.']
('Chandler', 'has-cousin', 'Phoebe')	['Ross', ' Y’know, she tried to undress me too.']	['Chandler', ' I used to undress my cousin Glenn.']	['Phoebe', ' Joseph Francis Tribbiani are you home yet?!!']
('Monica', 'has-cousin', 'Ross')	['Ross', ' Bec—Did you not hear me?! She’s an assistant professor in the Linguistics department, okay? They’re wild! Why do you want to come anyway?']	['Monica', ' Because! She’s my cousin. I mean, we grew up together! We’re family y’know? Well that’s important to me.']	['Ross', ' Okay, all right, I’ll take you. I’ll go call Joan.']
('Chandler', 'has-mother', 'Ross')	['Monica', " And they weren't looking at you before?!"]	['Chandler', " Finally, I figure I'd better answer it, and it turns out it's my mother, which is very-very weird, because- she never calls me!"]	['Ross', ' Hi.']
('Phoebe', 'has-mother', 'Chandler')	['Phoebe', ' Yeah me too.']	['Phoebe', ' Oh y’know what’s sadder than this? Bambi. I cried for three days with that movie. No wait two! Because on the third day my mother killed herself so I was partly crying for that.']	['Chandler', ' Well see now that I can see crying over, but Bambi is a cartoon!']
('Joey', 'has-mother', 'Ross')	['Rachel', ' Okay. I am so hot!']	['Joey', " Now, here's a picture of my mother and father on their wedding day. Now you tell me she's not a knockout."]	['Ross', " I cannot believe we're having this conversation."]
('Mr. Geller', 'has-mother', 'Mr. Geller')	['Ross', ' Thanks, Dad, really, I ju... you know, I just, I just needed to know, um... when did you start to feel like a father?']	['Mr. Geller', " Oh, well, I, I guess it musta been the day after you were born. We were in the hospital room, your mother was asleep, and they brought you in and gave you to me. You were this ugly little red thing, and all of a sudden you grabbed my finger with your whole fist. And you squeezed it, so tight. And that's when I knew."]	['Mr. Geller', " So you don't wanna go to Williamsburg?"]
('Rachel', 'has-mother', 'Monica')	['Phoebe', ' For how long?']	['Rachel', ' Eight weeks. I mean I love my mother, but my God, a long lunch with her is taxing.']	['Monica', ' I personally would be honored if she wanted to live with me.']
('Monica', 'has-mother', 'Chandler')	['Rachel', ' Nooo...']	['Monica', " This is so unfair! She's got everything I want, and she doesn't have my mother."]	['Chandler', ' How about Joey... Pepponi?']
('Phoebe', 'has-mother', 'Monica')	['Monica', ' You gotta help me out here Pheebs.']	['Phoebe', ' All right, I’ve never been engaged and I’ve never really been married, but I can only tell you what my mother told me. Whenever you have doubts or fears or anxieties about a relationship, do not communicate them to your husband.']	['Monica', ' So I’m not supposed to share my doubts and fears with the guy I’m gonna spend the rest of my life with?']
('Phoebe', 'has-mother', 'Carol')	['Ross', ' You wanna explain that?']	['Phoebe', " I mean, well, 'cause when I was growing up, you know my dad left, and my mother died, and my stepfather went to jail, so I barely had enough pieces of parents to make one whole one. And here's this little baby who has like three whole parents who care about it so much that they're fighting over who gets to love it the most. And it's not even born yet. It's just, it's just the luckiest baby in the whole world. I'm sorry, you were fighting."]	['Carol', ' Where are they?']
('Ross', 'has-son', 'All')	['Monica', ' Oh, but it’s made her so happy.']	['Ross', " Little girl misses her cat. Crazy lady thinks her mother is in a cat. Okay, y'know what, I have to go have dinner with my son, can I trust that when you see Phoebe, you will tell her."]	['All', ' Yeah.']
('Ross', 'has-mother', 'Phoebe')	['Phoebe', ' I think she would like that.']	['Ross', ' Come here, here, come here, come here, Mrs. Buffay. Sorry, about what I said, umm, it was, it was insensitive of me to say that you were just a cat. When clearly you are also the reincarnated spirit, of my friend’s mother.']	['Phoebe', ' Thank you. We both forgive you.']
('Paul', 'has-mother', 'Rachel')	['Rachel', ' I don’t care about the little dude! I can’t! I cannot listen to anymore of this! Y’know, the only person who would want to listen to this is a mental health professional! And then it’s only because they get paid $100 an hour! Do you know how much money I could’ve made listening to you? $2,000! And do you know when I figured that out? While you were talking!']	['Paul', ' What?! I can’t believe you’re trying to stifle me! When just 14 hours ago we figured out that that is exactly what my mother was trying to do to me!']	['Rachel', ' Oh… I’m sorry. I… I-I don’t mean—I didn’t mean to stifle you. I… This is all just a little overwhelming.']
('Chandler', 'has-father', 'Rachel')	['Monica', ' I can’t believe this. Do you think that your parents could help pay for it?']	['Chandler', ' I don’t know, my mother spent most of her money on her fourth wedding. She’s saving the rest for her divorce. And any extra cash my father has he saves for his yearly trips to Dollywood.']	['Rachel', ' Well what happened at dinner?']
('Rachel', 'has-mother', 'Joey')	['Joey', ' Yes! Yes! You did and you’re still yelling at me!']	['Rachel', ' No! No! No! I’m not yelling at you, I’m just yelling near you. Oh God Joey, ohh I’m my father. Oh my God, this is horrible! I’ve been trying so hard not to be my mother I did not see this comin’. Oh, Joey, I’m sorry. I’m so sorry. I just wanted you to learn.']	['Joey', ' Well, hey I did learn.']
('Phoebe', 'has-mother', 'Earl')	['Earl', ' It doesn’t really seem like enough to be fate.']	['Phoebe', ' Oh. Well umm, okay here’s a weird thing. My mother was also a supply manager.']	['Earl', ' I’m actually the office manager.']
('Mr. Geller', 'has-mother', 'Monica')	['Ross', ' What?!!!']	['Mr. Geller', ' I’ve been thinking about getting rid of it. I was driving it the other day and saw my reflection in a store window. Your mother’s right, I do look like an ass.']	['Monica', ' Wait, you’re giving me your Porsche, you’re kidding me right?!']
('Chandler', 'has-mother', 'Dennis Phillips')	['Mrs. Bing', ' Dennis is a dear old friend and a fantastic lover.']	['Chandler', ' Bravo Dennis thanks for pleasing my mother so.']	['Dennis Phillips', ' Oh, I’m so sorry I missed the ceremony, I was stuck at auditions.']
('Rachel', 'has-mother', 'Ross')	['Ross', ' You-you just said that you did!']	['Rachel', ' I know, I lied! I didn’t want her to think I was a terrible mother! I can’t even see my own baby!']	['Ross', ' Oh sure, come here! Sure you can! Uh, look come here look, it’s-it’s-it’s, it’s right there.']
("Mrs. Verhoeven's Daughter", 'has-mother', 'Ross')	['Ross', ' What?']	["Mrs. Verhoeven's Daughter", ' My mother’s still alive.']	['Ross', ' Oh, thank God!']
('Doug', 'has-mother', 'Chandler')	['Chandler', ' Oh uh, as it turns out, we can’t do it. Monica has to work.']	['Doug', ' Oh, my ex-wife didn’t work, unless you call turning into her mother\r\r work. Fine. Tomorrow night then.']	['Chandler', ' Oh uh well tomorrow’s no good for her either.']
('Monica', 'has-mother', 'Rachel')	['Rachel', ' What?! You mean they’re not coming to a social event where there’s no men and there’s no booze?! That’s shocking! I don’t care, as long as my mom’s here.']	['Monica', ' Oh my God, your mother!']	['Rachel', ' What?! My mom’s not gonna be here?!']
('Rachel', 'has-mother', 'Phoebe')	['Monica', ' Oh give it a rest!']	['Rachel', ' So my mother is not coming to my baby shower?!']	['Phoebe', ' No. Neither is mine.']
('Rachel', 'has-father', 'Rachel')	['Monica', ' And who pays for that? ']	['Rachel', ' Um... my... father. ']	['Rachel', ' Oh God, come on you guys, is this really necessary?  I mean, I can stop charging anytime I want. ']
('Rachel', 'has-father', 'Ross')	['Mona', ' Oh good, you’re here. Yeah, and I was worried that it was going to be uncomfortable.']	['Rachel', ' I know Mona, just hear me out. First of all, I’m so sorry about my father yelling at you, but I heard you totally held your own. You’re gonna have to tell me how you did that.']	['Ross', ' Focus.']
('Chandler', 'has-father', 'Monica')	['Rachel', " Yeah, well, it's a Mercedes if I move back home. Oh, it was horrible. He called me young lady."]	['Chandler', ' Ooh, I hate when my father calls me that.']	['Monica', ' Did he give you that whole "You\'re-not-up-to-this" thing again?']
('Rachel', 'has-father', 'Monica')	['Ross', " Yeah, uh, except for the red sock, which is still red. I'm sorry, please don't be upset, it could happen to anyone."]	['Rachel', " Except it didn't. It happened to me. Oh, god, I'm gonna look like a big marshmallow peep. What am I doing? What am I doing? My father's right. I can't live on my own! I can't even do laundry!"]	['Monica', " Something went wrong with Underdog, and they couldn't get his head to inflate. So anyway, um, his head is like flopping down Broadway, right, and I'm just thinking... how inappropriate this is. Um, I've got something in my eye, uh, Joey, could we check it in the light, please? "]
('Rachel', 'has-father', 'Terry')	['Terry', ' An advance?']	['Rachel', " It's so that I can spend Thanksgiving with my family. See, every year we go skiing in Vail, and normally my father pays for my ticket, but I sort of started the whole independence thing, you know, which is actually why I took this job."]	['Terry', " Rachel, Rachel, sweetheart. You're a terrible, terrible waitress. Really, really awful."]
('Mrs. Tribbiani', 'has-father', 'Joey')	['Joey', ' Hold on, you-you knew?']	['Mrs. Tribbiani', ' Of course I knew! What did you think? Your father is no James Bond. You should\'ve heard some of his cover stories. "I\'m sleeping over at my accountant\'s," I mean, what is that? Please!']	['Joey', ' So then how could you I mean, how could you?!']
('Ross', 'has-father', 'Mr. Geller')	['Mr. Geller', " I'm not freaking out, I'm just saying, if somebody had come to me with the idea andndash;"]	['Ross', ' Dad, dad, dad, I\'m talkin\' about the whole uh, baby thing. Did you uh, ever get this sort of... panicky, "Oh my god I\'m gonna be a father" kind of a thing?']	['Mr. Geller', " No. Your mother really did the work. I was busy with the business. I wasn't around that much. Is that what this is about?"]
('Joey', 'has-father', 'Lydia')	['Lydia', " She's not much of a phone person."]	['Joey', " Yeah, so, uh, so, uh, what's the deal with this father guy, I mean, if someone was havin' my baby somewhere, I'd wanna know about it, you know?"]	['Lydia', ' Hey, Knick fan, am I interested in your views on fatherhood? Uh, no. ']
('Chandler', 'has-father', 'Kathy')	['Kathy', " Not your type?! She's gorgeous!"]	['Chandler', " Y'know what I think it is? It's the fishnet stockings. Y'know? Whenever I see a girl in fishnet stockings it reminds me of my father in fishnet stockings."]	['Kathy', " Okay. Understanding a little more why you're single. Ohh! Y'know, I have a friend you would like, she's really pretty. And then we could double date!"]
('Frank Sr.', 'has-father', 'Phoebe')	['Phoebe', " Y'know what, it doesn’t matter what you say it's not gonna make a difference anyway, so you can just go."]	['Frank Sr.', " All right. Well, y'know in my defense I was a lousy father."]	['Phoebe', " That's a defense?"]
('Ross', 'has-son', 'Monica')	['Monica', ' Is he really coming? Because I can see right into your apartment!']	['Ross', ' Of course he is! What, do you think I’d just use my son as-as an excuse? What kind of father do you think I am?']	['Monica', ' All right, sorry.']
('Elizabeth', 'has-father', 'Ross')	['Wayne', ' It can do this.']	['Elizabeth', ' This is my father, Paul Stevens. Dad, this is Ross Geller.']	['Ross', ' It-it’s great to meet you Paul.']
('Ross', 'has-father', 'Rachel')	['Rachel', ' Ross, what’s the big deal? So I kissed the guy!']	['Ross', ' He is my girlfriend’s father, okay? It’s-it’s, it’s weird!']	['Rachel', ' Wh—You dated my sister!']
('Monica', 'has-father', 'Chandler')	['Chandler', ' I know.']	['Monica', ' You gave my father a lap dance!']	['Chandler', ' Why do they put so much steam in there?!']
('Rachel', 'has-father', 'Joey')	['Ross', ' You have to respect the sea!']	['Rachel', ' Look Joey, I’m sorry if-if you thought that was mean, but I gotta tell ya something. That was not mean. Okay, my father is mean. He used to yell at me all the time on the boat, I mean it was horrible. I was just being a good teacher.']	['Joey', ' Does a good teacher say, "Put down the beer pinhead!?"']
('Phoebe', 'has-father', 'Chandler')	['Monica', ' Phoebe, come on, you have to tell us.']	['Phoebe', ' Okay, okay. It’s James Brolin. James Brolin is the father of my baby.']	['Chandler', ' As in Barbara Streisand’s husband James Brolin?']
('Phoebe', 'has-father', 'Monica')	['Joey', ' The guy left this.']	['Phoebe', ' Oh my God! I know who the father is…']	['Monica', ' People have got to finish their stories!']
('Rachel', 'has-child', 'Ross')	['Ross', ' Oh uh, I’m sorry.']	['Rachel', ' No Ross! Ross! Ross! My child has no father!']	['Ross', ' Hi! I’m so glad you’re here, but it’s gonna be a while. I-I wished you’d called first.']
('Janice', 'has-father', 'Rachel')	['Rachel', ' Well I—That’s never gonna happen with Ross.']	['Janice', ' Oh well that’s what I thought about my first husband, now I’m lucky if my kid gets to spend the weekend with her father and the twins and little Ms. New Boobs.']	['Rachel', ' Really?']
('Phoebe', 'has-mom', 'Ross')	['Rachel', ' Oh my god!!']	['Phoebe', " No, no, no. It's not! It's not my mom. It belonged to mom. Yeah, no, she used to put it out every Christmas to remind us, that even though it's Christmas, people still die. And, you can put candy in it."]	['Ross', ' Hey!']
('Phoebe', 'has-mom', 'Rachel')	['Rachel', ' You just said it!']	['Phoebe', ' Oh. Okay, well I-I was kinda hoping that I would just…be alone y’know to think about my mom and her suicide.']	['Rachel', ' Oh Phoebe!']
('Joey', 'has-mom', 'Monica')	['Monica', ' Bye.']	['Joey', ' Have you kissed her yet? It’s awesome! I could do it forever! Y’know what? She-she kisses better than my mom cooks!']	['Monica', ' I am so glad you said cooks.']
('Phoebe', 'has-mom', 'Monica')	['Rachel', ' Well, isn’t that a good thing? You said you were sick of this.']	['Phoebe', ' I know. It’s just y’know usually when you’re, when you’re done with the pregnant thing, y’know, then you get to do the mom thing. I’m gonna be y’know, sitting around in my leather pants, drinking Tequila.']	['Monica', ' Some moms do that.']
('Chandler', 'has-mom', 'Ross')	['Ross', " No! Okay, you mean, you're not gonna talk to her, you're not gonna tell her how you feel?"]	['Chandler', " That would be no. Look, just because you played tonsil tennis with my mom doesn't mean you know her. Alright? Trust me, you can't talk to her."]	['Ross', " Okay, 'you' can't, or you can't? Okay, that's my finger. That's, that's my knee. Still doing the play. Aaah!"]
('Chandler', 'has-mom', 'Phoebe')	['Rachel', ' Just think, in a couple of years we get to turn into them.']	['Chandler', " If I turn into my parents, I'll either be an alcoholic blond chasing after twenty-year-old boys, or... I'll end up like my mom."]	['Phoebe', ' Hey.']
('Ross', 'has-mom', 'Chandler')	['Joey', ' The country?']	['Ross', " No no, this big pile of dishes in my mom's breakfront. Do you guys know who Carl is?"]	['Chandler', " Uh, let's see... Alvin... Simon... Theodore.... no."]
('Kathy', 'has-mom', 'Joey')	['Phoebe', ' They were threefold.']	['Kathy', ' Oh. Well uh, you not being able to talk may make this easier. Listen umm… Listen I don’t wanna be someone who comes between two best friends. I just, I can’t stand seeing what this is doing to you guys, and I don’t wanna be the cause of that. So, I don’t think we can see each other anymore. I’m gonna go to my mom’s in Chicago, I’m gonna stay there for awhile. I think this could’ve be something really amazing, but y’know this is probably for the best. Y’know? I’m gonna miss you. Good-bye, Chandler. ']	['Joey', ' Open the box!!']
('Phoebe', 'has-mom', 'Alice')	['Rachel', ' Ooh, it was only okay.']	['Phoebe', ' Ooh, I can’t do this. My mom was right. If I can’t-if I can’t give him up, then there’s no way I can give up a baby. Ohh, God, Frank and Alice are gonna be so crushed. What-what else, what else can I give ‘em—a kidney!']	['Alice', ' Hi!']
('Rachel', 'has-dad', 'Monica')	['Jill', ' That he wouldn’t pay for my lawyer! Then he told me to come here and learn about the value of money from the one daughter he’s actually proud off.']	['Rachel', ' Oh! Did you hear that?! My dad’s proud of me! My dad’s proud of me.']	['Monica', ' Rach?']
('Monica', 'has-mom', 'Phoebe')	['Phoebe', ' Wooo!! Hoo!!']	['Monica', ' I really like to say that I’m-um… Y’know what I’d really like to say? I’m drunk!! That’s right mom and dad your little Harmonica is hammered!! And guess what! I’ve been drunk before! And I’ve smoked a cigarette! And I got a box of Ding-Dongs hidden in my underwear drawer! It’s all okay. It’s okay because I turned thirty today. And, and I can do anything I want! Because I am a grown up.']	['Phoebe', ' Okay quick, help me get this off!']
('Phoebe', 'has-mom', 'Joey')	['Monica', ' Oh man! I did it again!']	['Phoebe', ' Okay, so umm, somebody has to call Frank and Alice. And then my mom wants to know--Joey, what are you doing?!']	['Joey', ' I gotta get the before shot!']
('Phoebe', 'has-mom', 'Chandler')	['Monica', ' Well, no. But, um, I bet she probably does.']	['Phoebe', ' Probably? Yeah, I don\'t like that word. Kind of what ‘probably’ really means. Yeah, uh-huh. Yeah, oh, "Your mom probably won\'t kill herself," y’know? I\'m sorry, but I\'m not hanging all my hopes of Rachel and I living together on-on "Probably!" Y’know? You gotta take care of yourselves! In this world history teaches us nothing!']	['Chandler', " Bing doesn't seem so weird now, does it?"]
('Rachel', 'has-mom', 'Ross')	['Ross', ' Wow! It looks like we got a lot of good stuff.']	['Rachel', ' Oh we did, but my mom got us the greatest gift of all.']	['Ross', ' A Play-Dough Barber Shop?']
('Phoebe', 'has-mom', 'Phoebe')	['Monica', " Hey, what's that?"]	['Phoebe', " Yeah, my mom sent me a family heirloom that once belonged to my grandmother. Can you believe it?! A year ago I didn't even have a family, and now I have heirlooms for crying out loud."]	['Phoebe', ' Eeeee--ohh!! God!']
('Tom', 'has-mom', 'Rachel')	['Danny', " You two could really hit it off! I'm gonna go mingle."]	['Tom', " So you work at Bloomingdale's, huh? My mom calls it Bloomies."]	['Rachel', ' Yeah, okay, at ease solider!']
('Paul', 'has-mom', 'Chandler')	['Rachel', ' Oh my God, what a great surprise! This is such a beautiful house.']	['Paul', ' Thank you, it’s my mom’s. So this is the kitchen.']	['Chandler', ' You’ve reached Monica and Chandler’s, if you’re listening to this message, we’re probably screening. Yeah we are.']
('Monica', 'has-mom', 'Chandler')	['Ross', ' No.']	['Monica', ' My God, I can’t believe this! I mean I knew that mom and dad were invited, but I thought that was it! I mean from the ages 7 to 9 Frannie and I were inseparable!']	['Chandler', ' Well, maybe since the age of 9, Frannie’s made some new friends.']
('Ross', 'has-mom', 'Phoebe')	['Monica', ' Look at this.']	['Ross', ' Oh, it looks like mom and dad’s house. Oh, it even has a tree with a broken limb out front and the uh, the window in the attic is…Oh my God!!']	['Phoebe', ' What? What happened to the window in the attic?!']
('Phoebe', 'has-mom', 'Earl')	['Earl', ' I thought it was toner.']	['Phoebe', ' No! Think about it okay? This isn’t even my regular job! Okay? And my first day on the job, you’re my first call! And-and somebody else might’ve hung up on you, but I wouldn’t do that because I know about this stuff. My mom killed herself.']	['Earl', ' Really?!']
('Ursula', 'has-mom', 'Phoebe')	['Ursula', ' Yeah, I got a big box of family stuff when my mom died.']	['Phoebe', ' Our mom.']	['Ursula', ' Right! Okay.']
('Chandler', 'has-mom', 'Monica')	['Monica', ' Chandler, look I-I know that your dad embarrassed you. I know…']	['Chandler', ' No-no all kids are embarrassed by their parents, you’d have to come up with a whole new word for what I went through. When I was in High School, he used to come to all of my swim meets dressed as a different Hollywood starlet. Y’know it’s hard enough to be fourteen. You’re skinny. You’re wearing speedoes—That your mom promised that you would grow into! And you look up into the stands and there’s your dad cheering you on dressed as Carmen Miranda. We was wearing a headdress with real fruit that he will later hand out to your friends as a healthy snack!']	['Monica', ' Hey, the point is that he was at everyone of your swim meets and he was there cheering you on! Okay? That’s a, that’s a pretty great dad.']
('Joey', 'has-mom', 'Chandler')	['Ross', ' Oh see, before you uh, when you showed it to me you-you held it that way which uh, which was misleading. Well I’m… Hello.']	['Joey', ' Chandler. Will you see if your mom can give my resume to Dennis Phillips? ‘Cause if I can get in a Broadway show then I would’ve done it all, film, television, and theater. The only think left would be radio, and that’s just for ugly people.']	['Chandler', ' What size shoes do you wear?']
('Dina', 'has-mom', 'Joey')	['Joey', ' Because! ‘Cause… ‘Cause you’re my baby sister!']	['Dina', ' And you’re my big brother! I mean, you’re my favorite guy in the whole world. I’m not even scared to tell mom and dad. I was scared of telling you.']	['Joey', ' Well I’d be scared of them, but all right.']
('Joey', 'has-dad', 'Rachel')	['Rachel', ' And so were-were you close to your parents?']	['Joey', ' Yeah, with my mom. Yeah, not so much with my dad.']	['Rachel', ' Why not?']
('Monica', 'has-parents', 'Mrs. Geller')	['Monica', ' Okay it’s time for the toast! Umm now-now, I know that Ross usually gives the toast, but this year I’m going to do it.']	['Monica', ' No, no it’s going to be great. Really! Mom, Dad, when I got married, one of the things that made me sure I could do it was the amazing example the two of you set for me. For that and so many other things I want to say thank you. I know I probably don’t say it enough, but I love you. When I look around this room, I’m-I’m saddened by the thought of those who could not be here with us. Nana, my beloved grandmother who would so want to be here, but she can’t because she’s dead. As is our dog Chi-Chi. I mean look how cute she is.. Was. Do me a favor and pass this to my parents. Remember she’s dead. Okay, her and Nana, gone. Wow! Hey does anybody remember when Debra Winger had to say goodbye to her children in Terms of Endearment? Didn’t see that? No movie fans?! You want to hear something sad? The other day I was watching 60 Minutes these orphans in Romania, who have been so neglected, they were incapable of love. You people are made of stone! Here’s to mom and dad! Whatever!']	['Mrs. Geller', ' Thank you Monica that was uh, interesting. Wasn’t it interesting, Jack?']
('Rachel', 'has-mom', 'Monica')	['Monica', ' Oh my God, your mother!']	['Rachel', ' What?! My mom’s not gonna be here?!']	['Monica', ' Well, given that we forgot to invite her it would be an awfully big coincidence if she was.']
('Rachel', 'has-mom', 'Phoebe')	['Monica', ' Okay, y’know what? Don’t worry, okay? We’ll take care of it. We’ll call her. Just go home and get ready.']	['Rachel', ' Please, make sure she comes. It’s really important to me, I mean it’s my mom!']	['Phoebe', ' I know. I know, what’s her number?']
('Rachel', 'has-mom', 'Mrs. Green')	['Mrs. Green', ' Of course I am!']	['Rachel', ' Oh mom, I swear I’m not an idiot. I’ve read all kinds of books on pregnancy and giving birth, but I-I just didn’t think to read the part about what to do when the baby comes. And-and then guess what? The baby’s coming and I don’t know what to do. Oh, can I throw up in my diaper genie?']	['Mrs. Green', ' No. Sweetie, you’re gonna be fine.']
('Joanne', 'has-dad', 'Kiki')	['Rachel', " So what's going on with you? "]	['Joanne', " Well, guess who my dad's making partner in his firm? "]	['Kiki', " And while we're on the subject of news.. "]
('Pizza Guy', 'has-dad', 'Monica')	['Rachel', " No, no, that's not what we ordered... We ordered a fat-free crust with extra cheese. "]	['Pizza Guy', " Wait, you're not 'G.Stephanopoulos?' Man, my dad's gonna kill me! "]	['Monica', " Wait! Did you say 'G.Stephanopoulos?' "]
('Joey', 'has-dad', 'All')	['Ross', ' Ohh, Geller’s got one hooked! Ohh! Looks like a big one! Yeah, ohh! Ohh! It’s the classic struggle between man and— Someone knocked over a lamp.']	['Joey', ' That’s all right. Hey you guys, you know what’s going to be great about the fishing trip this year? When my dad gets me out in the middle of the lake and gives me that, "Joey, what are you doing with your life?" stuff. I can say, "Well, I’m doing a movie with Charlton Heston dad. What are you doing with your life?"']	['All', ' Great!']
('Joey', 'has-dad', 'Ronni')	['Ronni', " Wow. He's strict."]	['Joey', " Now dad, you'll be in my room, Ronni uh, you can stay in Chandler's room."]	['Ronni', " Thanks. You're, uh, you're a good kid."]
('Joey', 'has-dad', 'Chandler')	['Chandler', ' Are they end to end, or tall like pancakes?']	['Joey', " Y'know what I mean, about how I'm always going out with all these women. And I always figured, when the right one comes along, I'd be able to be a stand-up guy and go the distance, y'know? Now I'm looking at my dad, thinking..."]	['Chandler', " Hey, you're not him. You're you. When they were all over you to go into your father's pipe-fitting business, did you cave?"]
('Ross', 'has-dad', 'Mr. Geller')	['Mr. Geller', ' I don’t know. They-they must be your mother’s, but please, please don’t ask her. I’ll throw these away.']	['Ross', ' Cool! Dad! My report cards! Hey, check this out dad, Math, A. Science, A. History, A. Gym… Oooh, my rock polisher!']	['Mr. Geller', ' Oh look, look there’s your old makeup kit!']
('Monica', 'has-dad', 'Rachel')	['Ross', ' Wow! Thanks, you guys. That’s uh—ohhh, I wanna, I wanna play you another piece! Umm! Uh-oh! I left my uh, helicopter sounds on another disk. I’ll be right back! Okay? This is so nice, I’m—I am so…']	['Monica', ' Oh God bless my dad sound proofing the basement!']	['Rachel', ' Oh, I can’t believe I ever let him touch me with those fingers.']
('Rachel', 'has-dad', 'Ross')	['Ross', ' Hey, I can handle it! All right?']	['Rachel', ' Please, Ross, you-you got hurt playing badminton with my dad.']	['Ross', ' That’s ‘cause-‘cause you’re mom’s dog kept-kept looking at me.']
('Ross', 'has-dad', 'Emily')	['Emily', ' Oh my God!']	['Ross', ' I made a man twice my size cry. I mean, I haven’t done that since I was four and I washed my dad’s Porsche with rocks.']	['Emily', ' You really enjoyed yourself didn’t you?']
('Joey', 'has-dad', 'Ross')	['Chandler', ' Forget it! Okay, I’m not giving up the apartment.']	['Joey', ' Oh come—look, when I was a kid my dad’s company gave season tickets to the number one salesman every year, all right? My dad never won! Of course, he wasn’t in the sales division, but still, I never ever, ever forgot that!']	['Ross', ' Hey, guys!']
('Phoebe', 'has-dad', 'Chandler')	['Ross', ' What happened?']	['Phoebe', ' That was my dad!']	['Chandler', ' Oh my God!']
('Phoebe', 'has-dad', 'Rachel')	['Joey', " Y'know what? Make fun all you want. This is a great bag! Okay? And it's as handy as it is becoming. Now, just because you don't understand something, doesn't make it wrong. All right? So from now on you guys are gonna have to get used to the fact that Joey, comes with a bag!"]	['Phoebe', " All right, I'd better go too. I have to go talk to my dad."]	['Rachel', ' Ooh, Pheebs, what are you gonna say? Are you gonna tell him who you are?']
('Rachel', 'has-dad', 'Rachel')	['Kim', ' Rachel? Do you smoke?']	['Rachel', " Oh no, my dad's a doctor and he would always tell me just horror stories……about ghosts and goblins who totally supported the princess's right to smoke."]	['Rachel', ' …and then they came back from smoking and they had made all of the decisions without me!']
('Ross', 'has-dad', 'Chandler')	['Ross', ' I went to Egypt with my dad.']	['Chandler', ' I can see it now, "Look dad, it’s the Sphinx!"']	['Ross', ' Hey, I think Elizabeth is a little more serious than, "Spring break!" All right? I mean she’s taken my class!']
('Elizabeth', 'has-dad', 'Rachel')	['Elizabeth', ' Ohh, I wouldn’t do it in there. That’s my dad’s bedroom.']	['Rachel', ' That’s your, that’s your dad’s bedroom. That’s your dad’s bedroom!']	['Paul', ' Why are you yelling?']
('Paul', 'has-dad', 'Chandler')	['Chandler', ' I’m a little busy here Paul.']	['Paul', ' That’s exactly what my dad used to say!']	['Chandler', ' Okay, a quick one. Come on hug it out. Oh hey! There you go. Okay.']
('Rachel', 'has-dad', 'Phoebe')	['Phoebe', ' Huh?']	['Rachel', ' I’m having dinner with my dad tomorrow night, do you wanna come?']	['Phoebe', ' Sure. Yeah, he’s kinda sexy.']
('Ross', 'has-dad', 'Monica')	['Ross', ' Now, I know you wanted to bond with my dad, but did you really have to bond to that part?']	['Monica', ' Listen, I’m sure that dad doesn’t care. He probably thought this was funny; he’ll be telling this story for years!']	['Chandler', ' I don’t want him to tell this story for years.']
('Ross', 'has-dad', 'Joey')	['Chandler', ' This is ridiculous. ']	['Ross', " Oh, is it? Is it? Look, when Monica and I were kids, we had a dog named Rover. And, uh, one day, my dad decides, he doesn't like dogs. So Monica and her friend…Phyllis…take away the dog. And that was the last time we ever saw him. Don't you see? This is just like that. Only with a few details changed. "]	['Joey', " Okay, I'm in my sweat pants. Bring on the food! What's the matter? "]
('Monica', 'has-dad', 'Ross')	['Phoebe', ' His first big kid’s bike, this is so exciting!']	['Monica', ' Oh yeah, I remember mine! Ohh, it was my sixth birthday, my dad took me to the park, I got it, and…it bent.']	['Ross', ' Yeah.']
('Chandler', 'has-dad', 'Ross')	['Phoebe', ' Well, we didn’t have a lot of money. But the girl across the street had the best bike! It was pink and it had rainbow colored tassels hanging off the handle grips, and-and-and a bell and this big, white wicker basket with those plastic daisies stuck on.']	['Chandler', ' That sounds like my first bike. My dad gave me his old one.']	['Ross', ' Ohh.']
('Monica', 'has-dad', 'Chandler')	['Chandler', ' Are you serious?! I mean like eloping?! No more stupid wedding stuff?! No more these flowers or these flowers or these flowers—Think of the money we’ll save!! We’re not eloping. I love the flowers. Can our wedding be bigger please?']	['Monica', ' We’re going to Las Vegas to see your dad. It’s time you two talked, and I want to get to know my father-in-law.']	['Chandler', ' Y’know we already went over this and I won!']
('Ross', 'has-dad', 'Phoebe')	['Monica', ' Look at this.']	['Ross', ' Oh, it looks like mom and dad’s house. Oh, it even has a tree with a broken limb out front and the uh, the window in the attic is…Oh my God!!']	['Phoebe', ' What? What happened to the window in the attic?!']
('Monica', 'has-dad', 'Phoebe')	['Phoebe', ' Wooo!! Hoo!!']	['Monica', ' I really like to say that I’m-um… Y’know what I’d really like to say? I’m drunk!! That’s right mom and dad your little Harmonica is hammered!! And guess what! I’ve been drunk before! And I’ve smoked a cigarette! And I got a box of Ding-Dongs hidden in my underwear drawer! It’s all okay. It’s okay because I turned thirty today. And, and I can do anything I want! Because I am a grown up.']	['Phoebe', ' Okay quick, help me get this off!']
('Chandler', 'has-dad', 'Monica')	['Monica', ' Honey, we gotta go!']	['Chandler', ' Okay. Here’s a question you never have to ask. My dad just called and wanted to know if he could borrow one of your pearl necklaces.']	['Monica', ' I don’t have anything like that, but let me go see if Rachel does.']
('Dina', 'has-dad', 'Joey')	['Joey', ' Because! ‘Cause… ‘Cause you’re my baby sister!']	['Dina', ' And you’re my big brother! I mean, you’re my favorite guy in the whole world. I’m not even scared to tell mom and dad. I was scared of telling you.']	['Joey', ' Well I’d be scared of them, but all right.']
('Mrs. Bing', 'has-son', 'All')	['Jay Leno', " Alright, so now you're doing this whole book tour thing, how is that going?"]	['Mrs. Bing', " Oh, fine. I'm leaving for New York tomorrow, which I hate- but I get to see my son, who I love..."]	['All', ' Awww!']
('Mrs. Bing', 'has-son', 'Chandler')	['Jay Leno', " Y'know, don't take this wrong, I-I just don't see you a-as a mom, somehow.. I don't mean that, I don't mean that bad..."]	['Mrs. Bing', ' Oh no, I am a fabulous mom! I bought my son his first condoms.']	['Chandler', ' ...And then he burst into flames.']
('Ross', 'has-son', 'Susan')	['Lydia', " Yeah, they're not so bad."]	['Ross', " Come on, come on. Damnit, damnit, damnit, damnit. This is all your fault. This is supposed to be, like, the greatest day of my life, y'know? My son is being born, and I should be in there, you know, instead of stuck in a closet with you."]	['Susan', " The woman I love is having a baby today. I've been waiting for this just as much as you have."]
('Ross', 'has-son', 'Ross')	['Salesman', ' Two days before Christmas? Sorry, man.']	['Ross', " Okay look, do-do, you have anything Christmassy? I promised my son, and I really don't want to disappoint him, um, come on, I…uh, you gotta have something."]	['Ross', " I'm the holiday armadillo! I'm a friend of Santa's and he sent me here to wish you a Merry Christmas!"]
('Ross', 'has-son', 'Emily')	['Emily', ' Yeah, but it-it-it’s my whole life—you come to England.']	['Ross', ' No, I can’t. I would, I really would, but my son is here; I can’t leave him. Isn’t—you don’t think there’s any way?']	['Emily', ' Ohh, I don’t think so. I mean it would be different if it was way into the future –and-and-and we were getting married or something.']
('Frank', 'has-son', 'Dr. Harad')	['Dr. Harad', ' All right. Keep pushing! Come on!']	['Frank', " I can't believe there's somebody coming out of you right now. There's somebody coming out of you! Is it? Is it? It's my son."]	['Dr. Harad', " All right. Here's your first baby."]
('Ross', 'has-son', 'Joey')	['Monica', ' Kinda. Oh my God!']	['Ross', ' Hello? Hey Mon, how’s the packing going? Ben? He’s fine. Yeah, he’s right—Oh my God! Get your head of your shirt there son! What? Yeah, it’s a pumpkin. I’ll come pack.']	['Joey', ' Hey!']
('Ross', 'has-son', 'Rachel')	['Rachel', ' That was you?! We heard about you in Junior High! Did you really just shake your fist in the air and shout, "I will be revenged?!"']	['Ross', ' I will be! Listen, I don’t want you teaching my son that stuff anymore. Okay?']	['Rachel', ' Fine. Fine, but I’ll have you know that once I taught him that stuff he called me Fun Aunt Rachel. And I loved being Fun Aunt Rachel but I’ll go back to being Boring and Uncomfortable Aunt Rachel if that’s what you want!']
('Ross', 'has-son', 'Katie')	['Rachel', ' All this stuff takes up a lot of room. Hey how uh, how serious are you about keeping Ben in your life?']	['Ross', ' My son? Pretty serious. Oh hey Katie! What uh, what are you doing here?']	['Katie', ' Well, the delivery went out to you and I realized they forgot this.']
('Ross', 'has-daughter', 'Mr. Waltham')	['Mr. Waltham', ' Goodbye Geller.']	['Ross', ' Now, hold on! Hold on! Look, look, your daughter and I are supposed to leave tonight for our honeymoon, now-now you-you tell her that I’m gonna be at that airport and I hope that she’ll be there too! Oh yeah, I said Rachel’s name, but it didn’t mean anything, Okay? She’s-she’s just a friend and that’s all! That’s all! Now just tell Emily that I love her and that I can’t imagine spending my life with anyone else. Please, promise me that you’ll tell her that.']	['Mr. Waltham', ' All right, I’ll tell her. Come on bugger face!']
('Phoebe', 'has-daughter', 'Frank Sr.')	['Frank Sr.', " Oh. Huh. It's huh, well it's oh it's—ew used. Umm, cool."]	['Phoebe', " Okay. I have just a few questions to ask so I'm going to get out my official forms. Okay, so, question 1) You and uh, you were married to Francis' daughter Lilly, is that correct?"]	['Frank Sr.', ' Yes, yes I was.']
('Jill', 'has-daughter', 'Rachel')	['Rachel', ' Wow! What did he say?']	['Jill', ' That he wouldn’t pay for my lawyer! Then he told me to come here and learn about the value of money from the one daughter he’s actually proud off.']	['Rachel', ' Oh! Did you hear that?! My dad’s proud of me! My dad’s proud of me.']
('Paul', 'has-daughter', 'Ross')	['Elizabeth', ' Okay. I didn’t know he was here.']	['Paul', ' Let me just see if I got this straight. I tell you to stay away from my daughter or I’ll have you fired. What you heard was, "Take my daughter, come up to my country house, and ruin my weekend with Rachel!"']	['Ross', ' Okay, please-please Paul, just let me explain…']
('Phoebe', 'has-daughter', 'Ross')	['Ross', ' Excuse me ladies. I’m sorry?']	['Phoebe', ' My massage client, Arthur? His daughter called and said that some guy that worked for me gave him a really weird massage this afternoon.']	['Ross', ' I gave him an extremely professional massage!']
('Dr. Green', 'has-daughter', 'Ross')	['Ross', ' Yes. Yes, yes I did. But-but it was, it was just a one night thing. It meant nothing.']	['Dr. Green', ' Oh? Really? That’s what my daughter means to you? Nothing?']	['Ross', ' No! No sir umm, she means a lot to me. I mean, I care—I-I love Rachel.']
('Mrs. Green', 'has-daughter', 'Monica')	['Monica', ' Hi, umm I know this is last minute, but we’ve decided to throw an impromptu baby shower for Rachel today.']	['Mrs. Green', ' I know, my daughter’s told me about it when they received their impromptu invitations a month ago.']	['Monica', ' Yeah, I’m sorry. I’m-I’m so sorry.']
('Rachel', 'has-niece', 'Ross')	['Ross', ' That’s right good things, that-that is what I said.']	['Rachel', ' Hello, Mark? Hi, it’s Rachel Green. Oh no, don’t you apologize. Yeah, I’ll hold. He left my number at work, but he was helping his niece with her report on the pioneers.']	['Ross', ' That is so made up!']
('Mr. Waltham', 'has-niece', 'Rachel')	['Rachel', ' Yes.']	['Mr. Waltham', ' I-I was wondering, my niece you see is in from London—well Shropshire really but y’know—well she’s about your age I say. Anyway I have tickets for the opera, Die Fledermaus, and I was wondering if you’d like to keep her company this evening?']	['Rachel', ' Sure. You got it. Great! ']
('Joey', 'has-parents', 'Monica')	['Monica', ' All right that’s it, I give up! Whatever you want you can have it! You wanna sing a song? You wanna do a dance? You want your mom stand at the Alter and scream racial slurs? I don’t care!']	['Joey', ' No! No, I-I just wanna thank you guys for what you did for my parents, that was really sweet. They’re so happy they get to be a part of your special day.']	['Monica', ' Oh.']
('Phoebe', 'has-twin', 'Malcom')	['Malcom', " So you spied on me. I can't believe you don't trust me."]	['Phoebe', " Oh well, what do you know, there goes my identical twin sister. Just walkin' along looking like me. What, is this just like a freakish coincidence, or did you know she takes this train?"]	['Malcom', " I'm sorry. I'm sorry. I tried to stop, but I couldn't. I'm so pathetic."]
('Joey', 'has-twin', 'Chandler')	['Chandler', ' Who the hell is Carl?!']	['Joey', ' Oh, did I not mention? Carl is a guy I hired to be my identical twin for a medical research project.']	['Chandler', ' Y’know sometimes the good ideas are just right in front of you, aren’t they?']
('Joey', 'has-twin', 'Phoebe')	['Phoebe', ' Yeah?']	['Joey', ' I found my identical hand twin!']	['Phoebe', " Ohh, you are so lucky! Hey! So, where's Monica? Did you guys make up?"]
('Joey', 'has-twin', 'Ross')	['Rachel', ' Hey!']	['Joey', ' Look-look-look you guys, I need some help! Okay? Someone is going to have to convince my hand twin to cooperate!']	['Ross', " I'll do it. Hey, whatever you need me to do, I'm your man. Whoa-oh-whoa! Are you, are you okay?"]
('Phoebe', 'has-aunt', 'Rachel')	['Rachel', ' Phoebe, what? Umm...what?!']	['Phoebe', ' Yeah, yeah, first there was my aunt Mary, and then there was umm, John, my mailman, and then my, my cowboy friend ‘Albino Bob’.']	['Rachel', ' And all these people actually died?']
('Kathy', 'has-aunt', 'Chandler')	['Chandler', ' Really?! You do that?']	['Kathy', ' Yeah, I do. Of course, I learned at my aunt’s dog grooming shop, but hey, what do you say?']	['Chandler', ' Dog grooming huh? Okay, just don’t make my tail too poofy.']
('Rachel', 'has-aunt', 'Ross')	['Joey', " But you haven't even heard the chorus!"]	['Rachel', " Oh my God, I'm starting to look like my great aunt, Muriel."]	['Ross', " All right. Y'know what? We don’t have to go downstairs! We can bring Vegas up to us! All right, come on, come on, we'll play some blackjack. Here we go. 13."]
('Ross', 'has-uncle', 'Phoebe')	['Luisa', ' Marcel?']	['Ross', ' My uncle Marcel.']	['Phoebe', " Oh, is that who the monkey's named after?"]
('Ross', 'has-uncle', 'Carol')	['Carol', ' What does he look like?']	['Ross', ' Kinda like my uncle Ed, covered in Jell-o.']	['Carol', ' Really?']
('Emily', 'has-uncle', 'Ross')	['Chandler', ' Without me?!']	['Emily', ' My uncle dragged us there. But, it actually it turned out to be really interesting.']	['Ross', ' Yeah.']
('Dina', 'has-uncle', 'Joey')	['Joey', ' Well I’d be scared of them, but all right.']	['Dina', ' Joey, I can’t stand the thought of having this baby with you mad at me. I want him to have his uncle. Is my baby gonna have his Uncle Joey?']	['Joey', ' Of course he’s gonna have his Uncle Joey!']
('Chandler', 'has-uncle', 'Joey')	['Phoebe', ' Bing, what an unusual name.']	['Chandler', ' Well you should meet my uncle, Bada. I’ll let myself out.']	['Joey', ' Hi.']
('Ross', 'has-child', 'Mrs. Geller')	['Monica', " So, Ross, what's going on with you? Any stories? No news, no little anecdotes to share with the folks? "]	['Ross', " Okay! Okay. Look, I, uh- I realise you guys have been wondering what exactly happened between Carol and me, and, so, well, here's the deal. Carol's a lesbian. She's living with a woman named Susan. She's pregnant with my child, and she and Susan are going to raise the baby. "]	['Mrs. Geller', ' And you knew about this?! ']
('Ross', 'has-child', 'Monica')	['Monica', ' All right, I know you’re hurting, and-and I want to be supportive, but don’t say that again.']	['Ross', ' Oh my God! What if, what if they get married? Then he’d be the stepfather of my child.']	['Monica', ' Honey, I don’t think that’s something we need to worry about! First of all he’s-he’s never gonna tell her how he feels about her. And even if he did you have no idea how she’d react.']
('Ross', 'has-child', 'Phoebe')	['Phoebe', ' Holy mother of God!!!']	['Ross', ' With my child.']	['Phoebe', ' That is brand new information!!']
('Phoebe', 'has-children', 'Ross')	['Susan', ' Yes.']	['Phoebe', " Hey, hey, ok, all right, that's it! Get in here. Come on. My god, you guys, I don't believe you. There are children coming into the world in this very building and your negative fighting noises are not the first thing they should be hearing. So just stop all the yelling, just stop it!"]	['Ross', ' Yeah, Susan.']
('Frank', 'has-children', 'Frank')	['Frank', ' Okay, okay, come on, you can do it. You can do it!']	['Frank', " Yeah!! Little Leslie is here! We got another one! Oh my God, I can't believe I have two-two children. How scary is that?"]	['Frank', " Come on little Chandler, it's time to be born. Come on little Chandler! Come on!"]
('Monica', 'has-children', 'Phoebe')	['Chandler', ' Dying people say the craziest things.']	['Monica', ' I wanted it for years! I was gonna make cookies for my children.']	['Phoebe', ' Break my heart—Oh, all right.']
('Monica', 'has-parent', 'Phoebe')	['Joey', " I can't! It-it's stuck!"]	['Monica', " Well, I don't care! That-that turkey has to feed 20 people at my parent's house and they're not gonna eat it off your head!"]	['Phoebe', " All right, hold on! Okay, let's just all think."]
('Joey', 'has-parent', 'Monica')	['Monica', ' I know! I know! I am a terrible person! I mean, Chandler is never going to trust me with anything ever again!']	['Joey', ' Oh hey! You got my parent’s gift!']	['Monica', ' Yeah. What is that?']
('Rachel', 'has-parents', 'Monica')	['Chandler', ' Oh, how well you know me... ']	['Rachel', " They're my new 'I don't need a job, I don't need my parents, I've got great boots' boots! "]	['Monica', " How'd you pay for them? "]
('Monica', 'has-parents', 'Chandler')	['Chandler', ' Yes!!']	['Monica', ' Oh no! My parents have never seen me drunk! That they know of.']	['Chandler', ' Okay, here’s the thing. We’re gonna get you some coffee and they will never know that you’re drunk.']
('Chandler', 'has-parents', 'Rachel')	['Phoebe', ' Him? Him, Ross?']	['Chandler', ' Nope, hymn 253, His Eyes Are On The Sparrow! When my parents got divorced is when I started using humour as a defence mechanism.']	['Rachel', ' Hi! Uhh, do you guys have plans for the weekend? Because I have my sister on hold, and she said that we could use her cabin for the weekend and go skiing. Huh? I’m asking you first, right?!. I mean I’m playing by the rules.']
('Rachel', 'has-parents', 'Chandler')	['Joey', " It's like if you woke up one day and found out your dad was leading this double life. He's like actually some spy, working for the C.I.A. That'd be cool.... This blows!"]	['Rachel', " I know, I mean, why can't parents just stay parents? Why do they have to become people? Why do they have... Why can't you stop staring at my breasts?"]	['Chandler', ' What? What?']
('Monica', 'has-parents', 'Phoebe')	['Rachel', ' Well what happened at dinner?']	['Monica', ' My parents spent the money for our wedding!']	['Phoebe', ' My God! What did you order?!']
('Chandler', 'has-dad', 'Janice')	['Janice', ' Okay.']	['Chandler', " I think you should go back with Gary. I don’t wanna be the guy that breaks up a family, y'know when my parents split up, it was because of that guy. Whenever I would see him I was always think y'know ‘You’re the reason, you are the reason why their not together.’ and I hated that guy. And it didn’t matter how nice he was, or how happy he made my Dad."]	['Janice', ' Wow!']
('Chandler', 'has-parents', 'Phoebe')	['Phoebe', " Whoa!! He is soo unreasonable! God, although I think I understand what he means. Oh my God, this is like 60 Minutes, okay, when, when, at first you’re really mad at that pharmaceutical company for making the drug and then y'know you just feel bad for the people because they needed to make their hair grow."]	['Chandler', " Y'know what this is like? This is like when my parents got divorced. Man, I hope Ross doesn’t try to kidnap me after Cub Scouts."]	['Phoebe', " Y'know I had a dream where Ross and Rachel were still together, they never broke up. And we were all just like hanging out, and everyone was happy...."]
('Chandler', 'has-parents', 'Monica')	['Monica', ' Chandler, look I-I know that your dad embarrassed you. I know…']	['Chandler', ' No-no all kids are embarrassed by their parents, you’d have to come up with a whole new word for what I went through. When I was in High School, he used to come to all of my swim meets dressed as a different Hollywood starlet. Y’know it’s hard enough to be fourteen. You’re skinny. You’re wearing speedoes—That your mom promised that you would grow into! And you look up into the stands and there’s your dad cheering you on dressed as Carmen Miranda. We was wearing a headdress with real fruit that he will later hand out to your friends as a healthy snack!']	['Monica', ' Hey, the point is that he was at everyone of your swim meets and he was there cheering you on! Okay? That’s a, that’s a pretty great dad.']
('Phoebe', 'has-dad', 'All')	['Rachel', ' That is so cool.']	['Phoebe', ' I know! So this woman probably could like have all kinds of stories about my parents, and she might even know like where my Dad is. So I looked her up, and she lives out by the beach. So maybe this weekend we could go to the beach?']	['All', ' Yeah! Yeah, we can!']
('Phoebe', 'has-parents', 'Ross')	['Joey', ' Woo-hoo! All right! Yeah!']	['Phoebe', ' Oh, I am having the best karma this week. First, I find this woman who knew my parents, and then my client with the fuzzy back gives me his beach house.']	['Ross', ' Yeah? What about ah, that bike messenger you hit?']
('Phoebe', 'has-parents', 'Phoebe Sr')	['Phoebe Sr', ' Oh no, I-I’m sorry, I guess we lost track of everybody after high school.']	['Phoebe', ' Oh, okay. Well, so tell me everything about my parents. Everything.']	['Phoebe Sr', " Ohh, well. Y'know we were always together, in fact the had a nickname for the three of us."]
('Monica', 'has-parents', 'Ross')	['Ross', ' Monica knows.']	['Monica', " It's this dumb thing that Ross made up `cause he was trying to fool our parents. It's a way of giving the finger, without actually having to give it. I remember I cried the night you made it up, `cause it was the first time that I realized that I was actually cooler than my older brother."]	['Ross', " Well, I'm gonna go get ready, for my date tonight, so ah, I'll just_ head."]
('Joshua', 'has-parents', 'Rachel')	['Rachel', ' Whoa-whoa, there’s two living rooms? God, growing up here, this place must’ve been a real babe magnet.']	['Joshua', ' Yeah, well, it would’ve been, but uh, my parents just moved here.']	['Rachel', ' Ohh, you should know, this place is a real babe magnet. Wanna make out?']
('Emily', 'has-parents', 'Ross')	['Ross', ' Yeah, I know, so what? I mean, who’s-who’s to say? Does that me we-we can’t do it? Look, huh, I was with Carol for four years before we got married and I wound up divorced from a pregnant lesbian. I mean, this, this makes sense for us. Come on! I mean, on our first date we ended up spending the whole weekend in Vermont! I mean, last night I got my ear pierced! Me! This feels right. Doesn’t it?']	['Emily', ' My parents are going to be really mad.']	['Ross', ' Is that—are you saying yes? Is that yes?']
('Big Nosed Rachel', 'has-parents', 'Fat Monica')	['Fat Monica', ' Oh, why? Why? What happened?']	['Big Nosed Rachel', ' Well, you know that my parents are out of town and Chip was going to come over…']	['Fat Monica', " Yeah, yeah, and you were going him y'know, your flower."]
('Ross', 'has-parents', 'Chandler')	['Chandler', ' You do? Why?']	['Ross', ' Okay, remember, we were young. Hey, Spring break, sophomore year, I got high in my bedroom and my parents walked in and smelled it and so I told them that you had gotten stoned and jumped out the window.']	['Chandler', ' What?! Why did you do that?']
('Ross', 'has-parents', 'Joey')	['Joey', ' Hey! Where have you been?']	['Ross', ' Oh, taking my parents back to the hotel.']	['Joey', ' Oh.']
('Joey', 'has-parents', 'Rachel')	['Joey', ' What the?!']	['Joey', ' Any one of the brilliant actresses nominated for this award tonight deserves to take it home. Unfortunately only one can. The nominees for Best Supporting Actress are from Passions Erin Goff. From One Life to Live Mary Loren Bishop, from All My Children Sarah Mchann, and from Days of Our Lives Jessica Ashley. And the winner is……Jessica Ashley from Days of Our Lives. Uh, unfortunately Jessica couldn’t be with us tonight so I’ll be accepting this award on her behalf. And I’m sure that Jessica would like to thank my parents who always believed in me. She’d also like to thank my friends, Chandler, Monica, Ross, Phoebe, and Rachel who’s sittin’ right there!']	['Rachel', ' Joey! Why did we have to rush out of there so fast?!']
('Paul', 'has-parents', 'Rachel')	['Rachel', ' Hm-mmm.']	['Paul', ' I wanted a big wheel. And instead my parents got me this little plastic chicken that you hop around on. It was embarrassing; kids made fun of me. That was a pretty tough year.']	['Rachel', ' That’s-that’s great! See? I already feel like I know you a little better! Thank you. Okay, come on. Now we can go eat. Let’s go.']
('Chandler', 'has-parents', 'Richard')	['{Transcriber’s Note', ' For further reading on the above story, please check out The One Where Joey Moves Out.}']	['Chandler', ' I got a good one, I got a good one! I once walked in on both my parents making love to the same guy.']	['Richard', ' It’s so great seeing you guys again. I’d like to make a toast. Uh, as a poet once said, "In the sweetness of friendship, let there be laughter and sharing of pleasures for in the due of little things the heart finds it’s morning and is refreshed."']
('Monica', 'has-parents', 'Rachel')	['Phoebe', ' Oh, I’m sorry. I’m so rude. Does anyone want to come to the movies?']	['Monica', ' All right, so I haven’t cleared the budget with my parents yet, but tell me how this is for music.']	['Rachel', ' Okay.']
('Phoebe', 'has-parents', 'The Teacher')	['The Teacher', ' Are you one of Ben’s mothers?']	['Phoebe', ' I am one of Ben’s mothers. I’m a lesbian. It was, it was difficult coming out to my parents.']	['The Teacher', ' Well hi, I’m Jenny Boone. I’m the new teacher here.']
('Monica', 'has-parents', 'Joey')	['Joey', ' Hey!']	['Monica', ' You got a present for my parents. That’s so sweet.']	['Joey', ' Yeah, yeah, in honor of their 35th wedding anniversary, I had a star named after them. ']
